11232123212321231111111111111111
10000000000000002111212111111111
10000000000000003113000311111111
11111111111112002112022111111111
11011111111112002112021111111111
11010000000112002110000300031111
11000000000113003110000000001111
11000000040000000000400000001111
11000000000112002110000000001113
11000000000112002113000300031113
11133212331112002111211303231113
11000000000112002110000303202113
11000000000113003110000300002123
11000000040000000000400333331113
11000000000112002110000300001113
11000000000112002110000000001113
11133212331112002111111311111113
11000000000112002110000004031351
11044444440113003110400000011595
11044444440000000000444444441202
11044444440112002110400000001202
11000000000112002110040000001202
11111111111112002111111111111202
11020200203112002110000000000002
11000000000113003110000000000001
11400040040000000000400000000001
11000000000112002110000000000001
12020202020212002110000000000001
12021202120212002110000000000001
12022202120222111110000000000002
13330002120000311111111111111202
11112221112222111111111111111131


