11111111111111111111111111111111
10000000000000000000000000000001
11111111111114040411111111111111
30000000011111010110000001113111
10110111000011000110111100110111
10110131111011110110113110000111
10110101111000140310110111011111
10110100000130000000310111011111
10110111110000140410000001300003
10110000001111000001111101110111
10100111101131013101111100000101
10101100001101000100000011111101
10030001111100010011111011110101
11111100000031111111111000000001
22222404222222222222222222222252
20000000000000000000000000000095
22222222222222222222222222222252
11111111111111111111111111111111
11111111111111111111111111111111
11111111111111111111111111111111
11111111111111111111111111111111
11111111111111111111111111111111
11111111111111111111111111111111
11111111111111111111111111111111
11111111111111111111111111111111
11111111111111111111111111111111
11111111111111111111111111111111
11111111111111111111111111111111
11111111111111111111111111111111
11111111111111111111111111111111
11111111111111111111111111111111
11111111111111111111111111111111


