11111111111111111111111111111111
10000000000000000000000000000001
11111111111114041111111111111111
30000000011111013110000001113111
10110111000011000110111100110111
10110131111011110110113110000111
10110101111000140410110111011111
10110100000130000000310111011111
10110111110000140410000001300003
10110000001111000001111101110111
10100111101131013101111100000101
10101100001101000100000011111101
10030001111100010011111011110101
11111100000031111111111000000001
22222202222222222222222222222222
20000000000000000000000000000002
22222222222222222222224042222222
11111111111111111131111011111111
11111111111111111101111013000001
11111111111111111101111011101101
11111111111111100000014041101101
11111111111111111111000000001101
11111111111130010001014041011101
11111111111111010101011011000031
11111111111111000100011011111111
11111111111111111111130000000003
11111111111111111111111111101111
11111111111111111111111111101111
11111111111111111111111111101111
15121212121212121212121212101212
59000000000000000000000000000002
15121212121212121212121212121212


