11111111111111111111111111111111
10000000000000000000000000000001
10000000000000000000000000000001
11111111111111111111111400411111
11111111111000000000000000000001
11111111111011232000000000000002
11111111111021111004000400040003
11111111111032111000000000000002
11111111111000111400040004000403
11111111111120211000000000000001
11111111111123112002111111123321
11111111131311112002111111113311
11111122211122214004111111112321
11111110000000000000000000000001
11111110044000044000044000044002
11112220044000044000044000044003
11132220000000000000000000000002
11132220000000000000000000000001
11112220044000044000044000044002
11111110044000044000044000044003
11111110000000000000000000000002
11111111200211111111111111200211
11111111200232120311111111200211
11111111200000000211111111200211
11111111111100000211111111200211
11111111111511111111111111200211
11111111115900000000000000000001
11111111111004004004004000000001
11111111111000000000000000000001
11111114111004004004004000000001
11111140000000000000000000000001
11111114111111111111111111111111


